###                 #########
#  ## #################   # #
# ###                 # # # #
# ################### # # # #
# 2       3           # # # #
##################### # # # #
#   ## 2     4        # # # #
# # ## ### ## ######7## # # #
# #    #   ##B#         # # #
# # ## ################ # # #
### ##    9        #### # # #
### ############## ## # # # #
###4            ##    # # # #
###### ######## ####### # # #
###### ####          8  #   #
A      ######################
